NO bonjour
SO comment
WE va
EA ca
F 255,0,255
C 0,255,0

11111
10001
10001
11111







11111111111111111111111111
10000000000000000000000001
11111111000000000000000001
       1000000000000000001
11111111111111111000000001
10000000000000000000000001
11111111111111111111111111

                                                                                                                1111
                                                                                                                100111111
                                                                                                                100000001
                                                                                                                111111111



























111
1W1
111
