NO ./textures/dungeon_wall1.xpm
SO ./textures/dungeon_wall1.xpm
WE ./textures/dungeon_wall1.xpm
EA ./textures/dungeon_wall1.xpm

F 0,0,0
C 0,0,0

DC ./textures/dungeon_door-closed.xpm

        1111111111111111111111111
        1000000000110000000000001
        1011000001110000000000001
        1001000000000000000000001
111111111011000001110000000000001
100000000011000001110111112111111
11110111111111011100000010N01
11110111111111011101010010001
11000000110101011100000010001
10000000000000001100000010001
10000000000000001101010010201
1100000111010101111101111000111
11110111 1110101 101111010001
11111111 1111111 111111111111
