NO bonjour
SO comment
EA ca
WE va

F 255,0,255
C 0,255,0

111111111111111111111
100000000000000000001
100N00000000000000001
100000000000000000001
100000000000000000001
100000000000000000001
100000000000000000001
100000000000000000001
100000000000000000001
111111111111111111111

