NO bonjour
SO comment
WE va
EA ca

F 255,0,255
C 0,255,

11111
10001
100N1
11111
